111111111
120010001
100000001
100010021
111111111
