1111111111111111111111111111111111111111111111111111111
1000000000000000000000000100000000000000000000000000001
1000000000000000000000000100000000000000000000000000001
1000000000000000000000000100000000000000000000000000001
1000000000000000000000000100000000000000000000000000001
1000000000000000000000000101110000000000000000000000001
1000000000000000000000000100010000000000000000000000001
1000000000000000000000000100010000000000000000000000001
1000000000000000000000000100110000000000000000000000001
1000000000000000000000000111110000000000000000000000001
1000000000000000000000000000000000000000000000000000001
1000000000000000000000000000000000000000000000000000001
1000000000000000000000000000000000000000000000000000001
1000000000000000000000000000000000000000000000000000001
1000000000000000000000000000000000000000000000000000001
1000000000000000000000000000000000000000000000000000001
1000000000000000000000000000000000000000000000000000001
1000000000000000000000000000000000000000000000000000001
1000000000000000000000000000000000000000000000000000001
1000000000000000000000000000000000000000000000000000001
1000000000000000000000000000000000000000000000000000001
1000020000000000000000000000000000000000000000000000001
1111111111111111111111111111111111111111111111111111111